"filename", "language", "C++", "Markdown", "XML", "comment", "blank", "total"
"d:\TLProject\Vscode\VsCode_C\Till_Language\Till_Language\Till_Language\Till_Language.vcxproj", "XML", 0, 0, -166, 0, 0, -166
"d:\TLProject\Vscode\VsCode_C\Till_Language\Till_Language\Till_Language\ast_node.h", "C++", -21, 0, 0, 0, -3, -24
"d:\TLProject\Vscode\VsCode_C\Till_Language\Till_Language\Till_Language\expression.cpp", "C++", -17, 0, 0, 0, -5, -22
"d:\TLProject\Vscode\VsCode_C\Till_Language\Till_Language\Till_Language\expression.h", "C++", -24, 0, 0, 0, -5, -29
"d:\TLProject\Vscode\VsCode_C\Till_Language\Till_Language\Till_Language\lexer.cpp", "C++", -200, 0, 0, 0, -14, -214
"d:\TLProject\Vscode\VsCode_C\Till_Language\Till_Language\Till_Language\lexer.h", "C++", -25, 0, 0, -34, -13, -72
"d:\TLProject\Vscode\VsCode_C\Till_Language\Till_Language\Till_Language\parser.cpp", "C++", -95, 0, 0, -9, -21, -125
"d:\TLProject\Vscode\VsCode_C\Till_Language\Till_Language\Till_Language\parser.h", "C++", -40, 0, 0, 0, -5, -45
"d:\TLProject\Vscode\VsCode_C\Till_Language\Till_Language\Till_Language\program.cpp", "C++", -23, 0, 0, -1, -5, -29
"d:\TLProject\Vscode\VsCode_C\Till_Language\Till_Language\Till_Language\program.h", "C++", -14, 0, 0, -7, -4, -25
"d:\TLProject\Vscode\VsCode_C\Till_Language\Till_Language\Till_Language\statement.cpp", "C++", -28, 0, 0, 0, -5, -33
"d:\TLProject\Vscode\VsCode_C\Till_Language\Till_Language\Till_Language\statement.h", "C++", -24, 0, 0, -3, -5, -32
"d:\TLProject\Vscode\VsCode_C\Till_Language\Till_Language\Till_Language\till.cpp", "C++", -62, 0, 0, -9, -12, -83
"d:\TLProject\Vscode\VsCode_C\Till_Language\Till_Language\Till_Language\token.cpp", "C++", -80, 0, 0, 0, -11, -91
"d:\TLProject\Vscode\VsCode_C\Till_Language\Till_Language\Till_Language\token.h", "C++", -54, 0, 0, 0, -5, -59
"d:\TLProject\Vscode\VsCode_C\Till_Language\Till_Language\Till_Language\语法.md", "Markdown", 0, -5, 0, 0, 0, -5
"d:\TLProject\Vscode\VsCode_C\Till_Language\src\ast.hpp", "C++", 107, 0, 0, 12, 16, 135
"d:\TLProject\Vscode\VsCode_C\Till_Language\src\lexer.cpp", "C++", 1237, 0, 0, 362, 324, 1923
"d:\TLProject\Vscode\VsCode_C\Till_Language\src\parser.cpp", "C++", 940, 0, 0, 263, 229, 1432
"d:\TLProject\Vscode\VsCode_C\Till_Language\src\parser.hpp", "C++", 68, 0, 0, 36, 14, 118
"d:\TLProject\Vscode\VsCode_C\Till_Language\src\till.cpp", "C++", 24, 0, 0, 15, 10, 49
"Total", "-", 1669, -5, -166, 625, 480, 2603