"filename", "language", "C++", "Markdown", "XML", "comment", "blank", "total"
"d:\TLProject\Vscode\VsCode_C\Till_Language\Till_Language\Till_Language\Till_Language.vcxproj", "XML", 0, 0, 166, 0, 0, 166
"d:\TLProject\Vscode\VsCode_C\Till_Language\Till_Language\Till_Language\ast_node.h", "C++", 21, 0, 0, 0, 3, 24
"d:\TLProject\Vscode\VsCode_C\Till_Language\Till_Language\Till_Language\expression.cpp", "C++", 55, 0, 0, 0, 12, 67
"d:\TLProject\Vscode\VsCode_C\Till_Language\Till_Language\Till_Language\expression.h", "C++", 50, 0, 0, 9, 13, 72
"d:\TLProject\Vscode\VsCode_C\Till_Language\Till_Language\Till_Language\lexer.cpp", "C++", 203, 0, 0, 0, 14, 217
"d:\TLProject\Vscode\VsCode_C\Till_Language\Till_Language\Till_Language\lexer.h", "C++", 25, 0, 0, 34, 13, 72
"d:\TLProject\Vscode\VsCode_C\Till_Language\Till_Language\Till_Language\parser.cpp", "C++", 275, 0, 0, 28, 58, 361
"d:\TLProject\Vscode\VsCode_C\Till_Language\Till_Language\Till_Language\parser.h", "C++", 63, 0, 0, 3, 8, 74
"d:\TLProject\Vscode\VsCode_C\Till_Language\Till_Language\Till_Language\program.cpp", "C++", 23, 0, 0, 1, 5, 29
"d:\TLProject\Vscode\VsCode_C\Till_Language\Till_Language\Till_Language\program.h", "C++", 14, 0, 0, 7, 4, 25
"d:\TLProject\Vscode\VsCode_C\Till_Language\Till_Language\Till_Language\statement.cpp", "C++", 68, 0, 0, 0, 13, 81
"d:\TLProject\Vscode\VsCode_C\Till_Language\Till_Language\Till_Language\statement.h", "C++", 51, 0, 0, 15, 11, 77
"d:\TLProject\Vscode\VsCode_C\Till_Language\Till_Language\Till_Language\till.cpp", "C++", 65, 0, 0, 9, 14, 88
"d:\TLProject\Vscode\VsCode_C\Till_Language\Till_Language\Till_Language\token.cpp", "C++", 80, 0, 0, 0, 11, 91
"d:\TLProject\Vscode\VsCode_C\Till_Language\Till_Language\Till_Language\token.h", "C++", 54, 0, 0, 0, 5, 59
"d:\TLProject\Vscode\VsCode_C\Till_Language\Till_Language\Till_Language\语法.md", "Markdown", 0, 5, 0, 0, 0, 5
"Total", "-", 1047, 5, 166, 106, 184, 1508