"filename", "language", "C++", "Markdown", "Bison", "Lex/Flex", "comment", "blank", "total"
"d:\TLProject\Vscode\VsCode_C\Till_Language\src\ast.cpp", "C++", 233, 0, 0, 0, 0, 25, 258
"d:\TLProject\Vscode\VsCode_C\Till_Language\src\ast.h", "C++", 147, 0, 0, 0, 15, 34, 196
"d:\TLProject\Vscode\VsCode_C\Till_Language\src\env.cpp", "C++", 50, 0, 0, 0, 2, 9, 61
"d:\TLProject\Vscode\VsCode_C\Till_Language\src\env.h", "C++", 38, 0, 0, 0, 0, 5, 43
"d:\TLProject\Vscode\VsCode_C\Till_Language\src\lang\till.l", "Lex/Flex", 0, 0, 0, 40, 0, 1, 41
"d:\TLProject\Vscode\VsCode_C\Till_Language\src\lang\till.y", "Bison", 0, 0, 98, 0, 19, 30, 147
"d:\TLProject\Vscode\VsCode_C\Till_Language\src\lang\语法.md", "Markdown", 0, 3, 0, 0, 0, 2, 5
"d:\TLProject\Vscode\VsCode_C\Till_Language\src\lexer.cpp", "C++", 1251, 0, 0, 0, 362, 324, 1937
"d:\TLProject\Vscode\VsCode_C\Till_Language\src\object.cpp", "C++", 215, 0, 0, 0, 0, 32, 247
"d:\TLProject\Vscode\VsCode_C\Till_Language\src\object.h", "C++", 56, 0, 0, 0, 0, 11, 67
"d:\TLProject\Vscode\VsCode_C\Till_Language\src\parser.cpp", "C++", 1073, 0, 0, 0, 263, 246, 1582
"d:\TLProject\Vscode\VsCode_C\Till_Language\src\parser.hpp", "C++", 68, 0, 0, 0, 36, 15, 119
"d:\TLProject\Vscode\VsCode_C\Till_Language\src\till.cpp", "C++", 31, 0, 0, 0, 0, 5, 36
"Total", "-", 3162, 3, 98, 40, 697, 739, 4739