"filename", "language", "Markdown", "C++", "XML", "comment", "blank", "total"
"d:\TLProject\Vscode\VsCode_C\Till_Language\Till_Language\Till_Language\Till_Language.vcxproj", "XML", 0, 0, 166, 0, 0, 166
"d:\TLProject\Vscode\VsCode_C\Till_Language\Till_Language\Till_Language\ast_node.h", "C++", 0, 21, 0, 0, 3, 24
"d:\TLProject\Vscode\VsCode_C\Till_Language\Till_Language\Till_Language\expression.cpp", "C++", 0, 17, 0, 0, 5, 22
"d:\TLProject\Vscode\VsCode_C\Till_Language\Till_Language\Till_Language\expression.h", "C++", 0, 24, 0, 0, 5, 29
"d:\TLProject\Vscode\VsCode_C\Till_Language\Till_Language\Till_Language\lexer.cpp", "C++", 0, 200, 0, 0, 14, 214
"d:\TLProject\Vscode\VsCode_C\Till_Language\Till_Language\Till_Language\lexer.h", "C++", 0, 25, 0, 34, 13, 72
"d:\TLProject\Vscode\VsCode_C\Till_Language\Till_Language\Till_Language\parser.cpp", "C++", 0, 95, 0, 9, 21, 125
"d:\TLProject\Vscode\VsCode_C\Till_Language\Till_Language\Till_Language\parser.h", "C++", 0, 40, 0, 0, 5, 45
"d:\TLProject\Vscode\VsCode_C\Till_Language\Till_Language\Till_Language\program.cpp", "C++", 0, 23, 0, 1, 5, 29
"d:\TLProject\Vscode\VsCode_C\Till_Language\Till_Language\Till_Language\program.h", "C++", 0, 14, 0, 7, 4, 25
"d:\TLProject\Vscode\VsCode_C\Till_Language\Till_Language\Till_Language\statement.cpp", "C++", 0, 28, 0, 0, 5, 33
"d:\TLProject\Vscode\VsCode_C\Till_Language\Till_Language\Till_Language\statement.h", "C++", 0, 24, 0, 3, 5, 32
"d:\TLProject\Vscode\VsCode_C\Till_Language\Till_Language\Till_Language\till.cpp", "C++", 0, 62, 0, 9, 12, 83
"d:\TLProject\Vscode\VsCode_C\Till_Language\Till_Language\Till_Language\token.cpp", "C++", 0, 80, 0, 0, 11, 91
"d:\TLProject\Vscode\VsCode_C\Till_Language\Till_Language\Till_Language\token.h", "C++", 0, 54, 0, 0, 5, 59
"d:\TLProject\Vscode\VsCode_C\Till_Language\Till_Language\Till_Language\语法.md", "Markdown", 5, 0, 0, 0, 0, 5
"Total", "-", 5, 707, 166, 63, 113, 1054